11111111111
10000000001
11110011011
1000001C011
10111011111
1E111000P01
11111111111


