111111111111111111111
1P00000000111CC011111
11111110000000000C001
1111100CC1110000000C1
1E0000011000CC1111111
111111111111111111111
