111111111111111111111
1P00000000111CC011111
11111110000000010C001
1111100CC1110000000C1
1E0000011000CC111-111
111111111111111111111
