




111111
1PCE01
111111












1