11111111111111111111
100P00000000000000C1
1110CC11000010000001
1C01110000000110C001
11CC000000000CC11111
1E11100CC000001C00C1
10001000001111CC0001
10C00111000001111001
1C000000000000000001
11111111111111111111