11111111111111111111
100P0000000000000001
11100011000010000001
1C01110000000110C001
11000000000000011111
10111000000000100001
10001000001111000001
10C00111000001111001
1000000000000E000001
11111111111111111111