11111111111111
10000000010001
10000011011001
10E00010C01001
10000011111101
100000000P0001
11111111111111
