11111111111111111111
10000000000000000001
10000000000000000001
10000000C00000000001
10000000000000000001
100000000E0000000001
10000000000000000001
100000000000P0000001
10000000000000000001
11111111111111111111