11111111111111111111
10000001010000000001
10000011011000000001
10000010C01000000001
10000011111100000001
100000000E0000000001
10000000000000000001
100000000000P0000001
10000000000000000001
11111111111111111111